bbbbbbbbbbbbbbbbbbbbbbbbbbbbbb
bbbbbbbbbbbbbbbbbbbbbbbbbbbbbb
b0000000000000000000000000000b
b0000000000000000000000000000b
b0000000000000000000000000000b
b0000000000000000000000000000b
b0000000000000000000000000000b
b00............00000000000000b
b00............00000000000000b
b00............00000000000000b
b00............00000000000000b
b00............00000000000000D
b00............000000000000000
b000000000000000000000000#0000
b00000000000000000000000000000
bbbbbbbbbbbbbbbbbbbbbbbbbbbbbb
bbbbbbbbbbbbbbbbbbbbbbbbbbbbbb
