bbbbbbbbbbbbbbbbbbbbbbbbbbbbbb
bbbbbbbbbbbbbbbbbbbbbbbbbbbbbb
b0000000000000000000000000000b
b0000000000000000000000000000b
b0000000000000000000#00000000b
b0000000000000000000000000000b
b000000000BbbbbbbB00000000000b
b00000000Bb......bB0000000000b
b00000000b........b0000000000b
b00000000b........b0000000000b
b00000000b........b0000000000b
d00000000b........b0000000000D
000000000b........b00000000000
000000000b........b00000000000
0000000s0bb......bb0s000000000
bbbbbbbbbbbbbbbbbbbbbbbbbbbbbb
bbbbbbbbbbbbbbbbbbbbbbbbbbbbbb