bbbbbbbbbbbbbbbbbbbbbbbbbbbbbb
bbbbbbbbbbbbbbbbbbbbbbbbbbbbbb
b0000000000000000000000000000b
b0000000000000000000000000000b
b0000000000000000000000000000b
b0000000000000000000000000000b
b0000000000000000000000000000b
b00000000000000BB000000000000b
b0000000000BB00bb000000000000b
b0000000000bb0#bb000000000000b
b0000000000bb00bb000000000000b
d0000000000bb00bb000000000000D
00000000000bb00bb0000000000000
00000000000bb00000000000000000
0000000s000bb0000000s000000000
bbbbbbbbbbbbbbbbbbbbbbbbbbbbbb
bbbbbbbbbbbbbbbbbbbbbbbbbbbbbb