bbbbbbbbbbbbbbbbbbbbbbbbbbbbbb
bbbbbbbbbbbbbbbbbbbbbbbbbbbbbb
b0000000000000000000000000000b
b00000000............00000000b
b00000000............00000000b
b00000000............00000000b
b00000000............00000000b
b0000000000000000000000000000b
b000000000000000BbbB000#00000b
b000000000000000BbbB000000000b
b00000BbbB0000000000000000000b
d00000BbbB0000000000000000000D
000000000000000000000000000000
000000000000BbbbB0000000000000
000000000000bbbbb0000000000000
bbbbbbbbbbbbbbbbbbbbbbbbbbbbbb
bbbbbbbbbbbbbbbbbbbbbbbbbbbbbb