bbbbbbbbbbbbbbbbbbbbbbbbbbbbbb
bbbbbbbbbbbbbbbbbbbbbbbbbbbbbb
b0000000000000000000000000000b
b00...........000000000000000b
b00...........000000000000000b
b00...........00000000000#000b
b00...........000000000000000b
b0000000000000000000000000000b
b000000000000000000BbbB000000b
b000000000000000000bbbb000000b
b00000000000BbB0000bbbb000000b
d00000000000bbb0000BbbB000000D
000000000000BbB000000000000000
0000000BbB00000000000000000000
0000000bbb00000000000000000000
bbbbbbbbbbbbbbbbbbbbbbbbbbbbbb
bbbbbbbbbbbbbbbbbbbbbbbbbbbbbb